TILEMAP
18 9				-- Size of tile map in tiles
16 16				-- Tile size & block size
images/level2_def.png 		-- Tilesheet
18 9				-- Number of tiles in tilesheet
17 144 145 161 157 75 3 4 113 48 12 13 86 41 78 85 2 14
0 9
0 0 2 3 4 4 3 4 4 3 4 41 12 13 14 0 0 0
18 19 55 1000 22 23 999 25 23 999 28 29 985 31 70 33 18 18
2 2 4 4 4 41 12 13 4 4 3 4 48 12 13 4 14 18
55 63 56 63 22 59 985 61 28 63 999 65 66 986 68 69 70 18
55 63 74 75 41 12 78 4 3 4 4 41 12 85 86 74 70 18
55 63 999 93 94 986 96 63 999 93 100 101 985 103 63 999 70 18
55 63 75 3 4 113 4 4 4 3 4 4 48 12 13 86 70 18
55 63 63 999 983 131 93 93 134 999 93 22 138 986 140 63 70 18
144 145 145 145 145 145 145 145 145 145 145 145 145 157 145 145 145 161
