TILEMAP
16 9 							-- Size of tile map in tiles
16 16 							-- Tile size & block size
images/level1.png 	-- Tilesheet
16 9 								-- Number of tiles in tilesheet
11 4 5 6 12 24 37 52 73 128 142 131
0 0 0 0 4 5 6 6 6 6 6 5 12 0 0 0
0 0 0 0 20 21 22 22 24 22 22 21 28 0 0 0
0 0 0 4 6 37 6 5 6 6 6 37 6 12 0 0
0 0 0 20 52 53 53 21 53 53 85 24 53 61 0 0
0 0 0 20 5 6 6 37 6 73 6 6 6 61 0 0
96 96 80 20 21 85 73 85 24 73 53 53 53 61 96 96
128 128 4 5 37 12 73 4 12 73 53 53 53 61 128 128
128 128 20 21 53 61 73 52 61 73 85 53 24 61 128 127
144 134 134 131 134 134 134 134 134 134 134 134 134 134 142 134


