TILEMAP
20 9				-- Size of tile map in tiles
16 16				-- Tile size & block size
images/level3-def.png		-- Tilesheet
20 9				-- Number of tiles in tilesheet
160 161 179 20 13 22 66 21 131 69
126 
0 0 0 0 0 5 6 7 8 8 8 11 20 13 21 21 13 22 0 0
20 21 22 23 20 21 21 135 13 21 22 31 40 999 34 35 36 50 0 0
40 41 50 43 40 45 46 47 999 45 50 31 20 21 21 55 22 50 0 0
40 999 50 63 40 45 66 21 21 69 50 31 40 45 74 75 76 50 0 0
20 21 21 55 22 85 86 45 45 89 50 31 92 45 35 95 45 50 0 0
40 35 102 103 50 105 45 107 86 999 50 31 999 45 105 115 116 50 0 0
40 45 20 135 13 22 126 66 13 21 21 131 21 55 13 135 22 50 0 0
40 141 40 141 999 141 146 141 999 149 149 151 152 153 999 155 156 50 158 0
160 161 161 161 161 161 161 161 161 161 161 161 161 161 161 161 161 161 161 179
