TILEMAP
18 9				-- Size of tile map in tiles
16 16				-- Tile size & block size
images/level02Images.png 		-- Tilesheet
11 5 				-- Number of tiles in tilesheet
0                               -- Number of collided tiles (none for now)
0   0   1   2   3  3  2   3   3   2   3 4  5 6  7  0  0  0 
8  9  10  22  12  13  14  15  13  14  15  16  17  18  19  20  8  8  
8  1  32  32  32  4  5  6  32  32  2  32  23 5  6  32  7 8 
8  10  24  27  12  16  17  18  26  27  14  27  16  29  18  30 19  8 
8  10  31  32  4  5  44  34  2  32 32  4 5  35 32  31  19  8  
8  10  14  36  16  29 18 37 14 36 13 16 17 18 27 14 19 8
8 38 32 2 32 39 32 32 32 2 32 32 23 5 6 32 19 8
8 40 27 14 27 13 36 36 27 14 36 41 16 29 18 27 19 8
43 55 55 55 55 55 55 55 55 55 55 55 55 45 55 55 55 46