TILEMAP
16 9 							-- Size of tile map in tiles
16 16 							-- Tile size & block size
images/level1.png 	-- Tilesheet
16 9 								-- Number of tiles in tilesheet
8 4 5 6 12 37 128 987 131
73
0 0 0 0 4 5 6 6 6 6 6 5 12 0 0 0
0 0 0 0 20 21 22 22 998 22 22 999 28 0 0 0
0 0 0 4 6 37 6 5 6 6 6 37 6 12 0 0
0 0 0 20 52 53 53 999 53 53 85 998 53 61 0 0
0 0 0 20 5 6 6 37 6 73 6 6 6 61 0 0
80 80 80 20 999 85 73 85 998 73 53 53 53 61 80 80
96 96 4 5 37 12 73 4 12 73 53 53 53 61 96 96
96 96 20 999 53 61 73 52 61 73 85 53 998 61 96 127
128 128 128 131 128 128 128 128 128 128 128 128 128 128 987 128


