TILEMAP
20 14				-- Size of tile map in tiles
16 16				-- Tile size & block size
images/level5-def.png		-- Tilesheet
20 14				-- Number of tiles in tilesheet
278 261 274 275 276 277 22 184 228 113 101 20 21 102 103 188 196 143 104 107 108
75
0 0 0 3 4 4 4 4 4 4 4 4 4 4 14 0 0 0 0 0
20 21 22 990 21 25 26 0 0 29 30 21 21 22 34 21 228 0 0 0
40 41 42 116 44 68 46 21 21 49 50 116 52 999 94 116 56 57 0 0
20 22 21 113 67 65 116 67 68 50 70 71 20 21 74 75 101 228 0 0
80 999 82 83 999 68 82 999 68 68 71 91 40 93 94 95 96 97 0 0
80 101 102 103 104 21 22 107 108 22 21 21 21 113 94 115 116 97 0 0
80 116 122 985 124 116 999 127 128 999 52 133 132 133 94 75 52 56 0 0
40 116 20 143 103 104 21 102 103 104 21 21 21 22 991 22 21 21 228 0
160 52 40 122 986 124 166 122 985 124 170 70 172 999 174 999 176 177 97 0
220 20 21 21 184 21 102 103 188 113 190 191 192 101 21 21 992 113 97 0
220 80 202 203 116 205 122 986 124 97 210 190 212 202 116 52 94 217 97 0
220 80 222 223 224 22 21 184 228 97 67 231 190 233 116 101 997 113 97 0
240 40 242 224 244 999 246 133 56 56 999 251 252 190 254 116 116 202 56 0
278 261 261 263 264 261 261 261 261 261 261 261 261 261 274 275 276 277 278 274
