TILEMAP
16 13				-- Size of tile map in tiles
16 16				-- Tile size & block size
images/level4-def.png		-- Tilesheet
16 13				-- Number of tiles in tilesheet
0
0 0 0 0 0 0 6 7 8 8 8 11 12 107 7 15
0 0 0 0 0 0 67 999 24 25 26 27 28 29 999 31
32 32 32 6 36 37 7 8 15 25 6 7 44 45 107 15
48 49 50 51 52 53 999 86 31 57 67 999 27 122 29 31
48 65 48 67 68 8 8 8 11 73 107 8 7 77 78 31
48 65 48 67 167 25 86 87 27 28 29 91 999 93 25 31
48 65 98 67 999 101 102 103 68 44 106 107 8 78 167 31
112 113 114 8 8 117 147 119 25 27 122 29 25 25 999 127
128 129 102 131 149 133 134 78 140 68 77 78 140 36 7 143
128 8 146 147 148 149 87 151 168 25 154 25 186 157 999 159
128 166 162 163 147 25 166 167 168 25 170 171 172 113 7 143
128 149 999 194 180 147 182 999 186 101 186 187 188 189 190 191
128 193 194 194 194 197 198 198 198 198 198 194 204 205 206 207
