TILEMAP
18 9				-- Size of tile map in tiles
16 16				-- Tile size & block size
images/level2_def.png 		-- Tilesheet
18 9				-- Number of tiles in tilesheet
0
0 0 2 3 4 4 3 4 4 3 4 41 12 13 14 0 0 0
18 19 55 21 22 23 24 25 23 24 28 29 30 31 70 33 18 18
18 2 4 4 4 41 12 13 4 4 3 4 48 12 13 4 14 18
18 55 56 63 22 59 30 61 28 63 24 65 66 67 68 69 70 18
18 55 74 75 41 12 78 4 3 4 82 41 12 85 86 74 70 18
18 55 24 93 94 67 96 63 24 93 100 101 30 103 63 24 70 18
18 55 75 3 4 113 4 4 4 3 4 4 48 12 13 86 70 18
18 55 63 24 63 131 93 93 134 24 93 22 138 67 140 63 70 18
144 145 145 145 145 145 145 145 145 145 145 145 145 157 145 145 145 161
